看书，读书， 阅读


mots se trouvant dans les concordances sur itrameur, les plus comprehensibles et logiques
习惯 - habitude
爱 - aimer 
时间 - temps (sens de longueur de temps)
养成 - cultiver, acquérir (une compétence)
方法 - méthode
手机 - téléphone
好处 - avantage
忙 - occupé
练习 - s'entrainer
喜欢 - aimer
能力 - capacité
兴趣 - hobby
重要性 - importance
大学生 - étudiant (à l'université)
亲子 - parents et enfants
幼儿 - enfants (assez jeunes)
小时 - heure
静 - calme, silence
有用 - utile
孩子 - enfants
调查 - sondage, enquête
功利性 - utilité
培养 - développer, élever
言语 - parler
成功 - (avoir du) succès
中国 - chine
觉得 - trouver que

mots dans le dictionnaire sur itrameur avec le corpus dumps-text-chinois-final, les mots les plus utilisés
书 - livre
书籍 - livre, littérature
知识 - savoir (le)
学习 - étudier
电子书 - ebook
生活 - vie
图书馆 - bibliothèque
故事 - histoire
工作 - travail
社会 - société
开始 - commencer
电视 - télé
